9 37
|-----------------------------------|
|E................|................E|
|....|.........................|....|
|..........|.............|..........|
|....---...|......@......|...---....|
|..........|.............|..........|
|....|.........................|....|
|E................|................E|
|-----------------------------------|